################
#      @       #
#              #
#       L      #
#              #
#              #
#              #
#              #
#              #
#              #
#              #
#              #
#              #
#S SSSSSSS     #
#    S SSSSSSS #
################
