################
#      @       #
#              #
#              #
#    OOXOO     #
#              #
#              #
#              #
#       L      #
#              #
#              #
#              #
#              #
#              #
#              #
################
